■■■■■■■■■■■■■■■■■■■■■■■■■
■U■■■■■■■■@&&@■■■@@&@@■■■
■@■■@@@■■■@■■@■■■@■■■@■■■
■@■■@■@■■■@■■@■■■@■■■@■■■
■@@@@■@■■■@@@@@■■@■■@@■■■
■■■■■■@■■■@■■■@■■@■■@■■■■
■@&&&@@■■■@■■■@■■@■■@@■■■
■@■■■■@■■■@■■■@@@@■■■@■■■
■@■■■■@■■■@@@■■■■■■■■@■@■
■■@@@@@■■■■■@■@@@&@@■@■&■
■■@■■■■■■■■■@■■■■■■@@@■&■
■■@■■■■■■■■■@@@@@■■■@■&&■
■■&■■@@@@@■■■■■■@■■■@■@■■
■■@■■@■■■@■@@@@■@■■■@■@@■
■■@■■@■■■@■@■■@■@■■■@■■&■
■■@■■@■■■@■@■■■■@■■■@■■@■
■■@@@@■■■@■@@@■■@■■■@■■&■
■■■■■■■■■@■■■@■■@■■■@■■@■
■@&&&@■■■@■■■@■■@■■■@@@@■
■■■■■@■■■@■■■@■■@■■@@■■■■
■■@@@@@@@@@@@@■■@■■@■■■@■
■■@■■■■■@■■■■■■■@■@@■■■@■
■■@■■■■■@@@&&@■■@■@■■@@@■
■■@■■■■■■■■■■■■■@■@■■@■■■
■■@@@@@@@&@@@@@@@■@@&@@@→
■■■■■■■■■■■■■■■■■■■■■■■■■